            ┌───────────────────────┐                         
            │                       │                         
            │                       │                         
            │                       │                         
            │     ┌───────────┐     │                         
            │     │           │     │                         
            │     │           │     │                         
            │     │           │     │                         
            │     │           │     │                         
            │     │           │     │                         
            │     │           │     │                         
            │     │           │     │                         
            │     │           │     └─────────────────────────
            │     │           │                              @
            │     │           │                              @
            │     │           │                              @
            │     │           └───────────────────────────────
            │     │                                           
            │     │                                           
@───────────┘     │                                           
@                 │                                           
@                 │                                           
@                 │                                           
@─────────────────┘                                           